# adiego 2007
# https://en.wikipedia.org/wiki/Carian_alphabets
ğŠ 	a
ğŠ¡	B
ğŠ¢	d
ğŠ£	l
ğŠ¤	y
ğŠ¥	r
ğŠ¦	L
ğŠ§	a
ğŠ¨	q
ğŠ©	b
ğŠª	m
ğŠ«	o
ğŠ¬	d
ğŠ­	t
ğŠ®	sh
ğŠ¯	sh
ğŠ°	s
ğŠ±	?
ğŠ²	u
ğŠ³	n
ğŠ´	k
ğŠµ	n
ğŠ¶	T
ğŠ·	p
ğŠ¸	s
ğŠ¹	i
ğŠº	e
ğŠ»	y
ğŠ¼	k
ğŠ½	k
ğŠ¾	D
ğŠ¿	w
ğ‹€	G
ğ‹	G
ğ‹‚	z
ğ‹ƒ	z
ğ‹„	ng
ğ‹…	j
ğ‹†	?
ğ‹‡	T
ğ‹ˆ	y
ğ‹‰	r
ğ‹Š	B
ğ‹‹	B
ğ‹Œ	B
ğ‹	B
ğ‹	L
ğ‹	e
ğ‹	y
