# iso 15919
рдБ	m
рдВ	m
рдГ	h
рдЕ	a
рдЖ	a
рдЗ	i
рдИ	i
рдЙ	u
рдК	u
рдЛ	r
рдМ	l
рдН	e
рдО	e
рдП	e
рдР	ai
рдС	o
рдТ	o
рдУ	o
рдФ	au
рдХ	k
рдЦ	kh
рдЧ	g
рдШ	gh
рдЩ	n
рдЪ	c
рдЫ	ch
рдЬ	j
рдЭ	jh
рдЮ	n
рдЯ	t
рда	th
рдб	d
рдв	dh
рдг	n
рдд	t
рде	th
рдж	d
рдз	dh
рди	n
рдй	n
рдк	p
рдл	ph
рдм	b
рдн	bh
рдо	m
рдп	y
рд░	r
рд▒	r
рд▓	l
рд│	l
рд┤	l
рд╡	v
рд╢	s
рд╖	s
рд╕	s
рд╣	h
рд╜	'
рд╛	a
рд┐	i
реА	i
реБ	u
реВ	u
реГ	r
реД	r
реЕ	e
реЗ	e
реИ	ai
реЙ	o
реЛ	o
реМ	au
реШ	q
реЩ	kh
реЪ	g
реЫ	z
реЬ	r
реЭ	rh
реЮ	f
реЯ	y
реа	r
реб	l
рев	l
рег	l
# other
рдА	m
рдД	a
рд║	o
рд╗	o
рд╝	'
реЖ	e
реК	o
реН	
реО	e
реП	a
реР	Om
реС	
реТ	
реУ	
реФ	
реХ	e
реЦ	u
реЧ	u
ред	,
рее	.
ре░	.
ре▒	'
ре▓	a
ре│	o
ре┤	o
ре╡	a
ре╢	u
ре╖	u
ре╕	d
ре╣	zh
ре║	y
ре╗	g
ре╝	j
ре╜	'
ре╛	d
ре┐	b
ъга	0
ъгб	1
ъгв	2
ъгг	3
ъгд	4
ъге	5
ъгж	6
ъгз	7
ъги	8
ъгй	9
ъгк	a
ъгл	u
ъгм	k
ъгн	n
ъго	p
ъгп	r
ъг░	v
ъг▒	'
ъг▓	m
ъг│	m
ъг┤	mm
ъг╡	m2
ъг╢	m3
ъг╖	m'
ъг╕	-
ъг╣	-
ъг║	^
ъг╗	~
ъг╝	*
ъг╜	Om
ъг╛	a
ъг┐	a
# Devanagari Extended-A
# https://unicode.org/charts/PDF/U11B00.pdf
# https://unicode.org/L2/L2021/21102-devanagari-bhale-mindu.pdf
## Head marks
ЁСмА	#
ЁСмБ	#
## Auspicious signs
ЁСмВ	5
ЁСмГ	6
ЁСмД	8
ЁСмЕ	9
ЁСмЖ	5
ЁСмЗ	9
ЁСмИ	9
ЁСмЙ	0
