# https://hunterwb.com/hangul
#
# Revised Romanization, special provision 8
## consonants
ᄀ	g
ᄁ	kk
ᄂ	n
ᄃ	d
ᄄ	tt
ᄅ	l
ᄆ	m
ᄇ	b
ᄈ	pp
ᄉ	s
ᄊ	ss
ᄋ	
ᄌ	j
ᄍ	jj
ᄎ	ch
ᄏ	k
ᄐ	t
ᄑ	p
ᄒ	h
## final consonants
ᆼ	ng
## vowels
ᅡ	a
ᅢ	ae
ᅣ	ya
ᅤ	yae
ᅥ	eo
ᅦ	e
ᅧ	yeo
ᅨ	ye
ᅩ	o
ᅪ	wa
ᅫ	wae
ᅬ	oe
ᅭ	yo
ᅮ	u
ᅯ	wo
ᅰ	we
ᅱ	wi
ᅲ	yu
ᅳ	eu
ᅴ	ui
ᅵ	i
# filler
ᅟ	
ᅠ	
# old consonants
ᅀ	z
ᅌ	ng
ᅙ	q
# light consonants
ᄛ	r
ᄝ	w
ᄫ	v
ᄬ	ff
ᅗ	f
# incisor consonants
## left
ᄼ	ᄉ
ᄽ	ᄊ
ᅎ	ᄌ
ᅏ	ᄍ
ᅔ	ᄎ
## right
ᄾ	ᄉ
ᄿ	ᄊ
ᅐ	ᄌ
ᅑ	ᄍ
ᅕ	ᄎ
# old vowels
ᆞ	o
ᆢ	yo
