# ala-lc 2012
ã‚¢	a
ã‚¤	i
ã‚¦	u
ã‚¨	e
ã‚ª	o
ã‚«	ka
ã‚¬	ga
ã‚­	ki
ã‚®	gi
ã‚¯	ku
ã‚°	gu
ã‚±	ke
ã‚²	ge
ã‚³	ko
ã‚´	go
ã‚µ	sa
ã‚¶	za
ã‚·	shi
ã‚¸	ji
ã‚¹	su
ã‚º	zu
ã‚»	se
ã‚¼	ze
ã‚½	so
ã‚¾	zo
ã‚¿	ta
ãƒ€	da
ãƒ	chi
ãƒ‚	ji
ãƒ„	tsu
ãƒ…	zu
ãƒ†	te
ãƒ‡	de
ãƒˆ	to
ãƒ‰	do
ãƒŠ	na
ãƒ‹	ni
ãƒŒ	nu
ãƒ	ne
ãƒŽ	no
ãƒ	ha
ãƒ	ba
ãƒ‘	pa
ãƒ’	hi
ãƒ“	bi
ãƒ”	pi
ãƒ•	fu
ãƒ–	bu
ãƒ—	pu
ãƒ˜	he
ãƒ™	be
ãƒš	pe
ãƒ›	ho
ãƒœ	bo
ãƒ	po
ãƒž	ma
ãƒŸ	mi
ãƒ 	mu
ãƒ¡	me
ãƒ¢	mo
ãƒ¤	ya
ãƒ¦	yu
ãƒ¨	yo
ãƒ©	ra
ãƒª	ri
ãƒ«	ru
ãƒ¬	re
ãƒ­	ro
ãƒ¯	wa
ãƒ°	i
ãƒ±	e
ãƒ²	o
ãƒ³	n
# v
ãƒ´	vu
ãƒ·	va
ãƒ¸	vi
ãƒ¹	ve
ãƒº	vo
# other
ãƒ½	>
ãƒ¾	>"
ð›€€	e
# punctuation
ã‚ 	=
ãƒ»	-
ãƒ¼	-