# https://unicode.org/charts/PDF/U16D40.pdf
# https://unicode.org/L2/L2022/22043r-kirat-rai.pdf
# Various signs
ЁЦ╡А	n
ЁЦ╡Б	m
ЁЦ╡В	'
# Independent vowel
ЁЦ╡Г	a
# Consonants
ЁЦ╡Д	k
ЁЦ╡Е	kh
ЁЦ╡Ж	g
ЁЦ╡З	gh
ЁЦ╡И	n
ЁЦ╡Й	c
ЁЦ╡К	ch
ЁЦ╡Л	j
ЁЦ╡М	jh
ЁЦ╡Н	n
ЁЦ╡О	t
ЁЦ╡П	th
ЁЦ╡Р	d
ЁЦ╡С	dh
ЁЦ╡Т	t
ЁЦ╡У	th
ЁЦ╡Ф	d
ЁЦ╡Х	dh
ЁЦ╡Ц	n
ЁЦ╡Ч	p
ЁЦ╡Ш	ph
ЁЦ╡Щ	b
ЁЦ╡Ъ	bh
ЁЦ╡Ы	m
ЁЦ╡Ь	y
ЁЦ╡Э	r
ЁЦ╡Ю	l
ЁЦ╡Я	v
ЁЦ╡а	s
ЁЦ╡б	s
ЁЦ╡в	h
# Vowel signs
ЁЦ╡г	a
ЁЦ╡д	i
ЁЦ╡е	u
ЁЦ╡ж	u
ЁЦ╡з	e
ЁЦ╡и	ai
ЁЦ╡й	o
ЁЦ╡к	au
# Various signs
ЁЦ╡л	
ЁЦ╡м	
ЁЦ╡н	.
# Punctuation
ЁЦ╡о	ред
ЁЦ╡п	рее
