# https://unicode.org/charts/PDF/U10280.pdf
# https://unicode.org/wg2/docs/n3019.pdf
## Melchert 2004
ğŠ€	a
ğŠ	e
ğŠ‚	b
ğŠƒ	b
ğŠ„	g
ğŠ…	d
ğŠ†	i
ğŠ‡	w
ğŠˆ	z
ğŠ‰	th
ğŠŠ	y
ğŠ‹	k
ğŠŒ	q
ğŠ	l
ğŠ	m
ğŠ	n
ğŠ	m
ğŠ‘	n
ğŠ’	u
ğŠ“	p
ğŠ”	k
ğŠ•	r
ğŠ–	s
ğŠ—	t
ğŠ˜	t
ğŠ™	a
ğŠš	e
ğŠ›	h
ğŠœ	x
