# https://www.unicode.org/charts/PDF/U1F0A0.pdf
ğŸ‚ 	-
# spades
ğŸ‚¡	As
ğŸ‚¢	2s
ğŸ‚£	3s
ğŸ‚¤	4s
ğŸ‚¥	5s
ğŸ‚¦	6s
ğŸ‚§	7s
ğŸ‚¨	8s
ğŸ‚©	9s
ğŸ‚ª	Ts
ğŸ‚«	Js
ğŸ‚¬	Ns
ğŸ‚­	Qs
ğŸ‚®	Ks
# hearts
ğŸ‚±	Ah
ğŸ‚²	2h
ğŸ‚³	3h
ğŸ‚´	4h
ğŸ‚µ	5h
ğŸ‚¶	6h
ğŸ‚·	7h
ğŸ‚¸	8h
ğŸ‚¹	9h
ğŸ‚º	Th
ğŸ‚»	Jh
ğŸ‚¼	Nh
ğŸ‚½	Qh
ğŸ‚¾	Kh
#
#ğŸ‚¿	playing card red joker
# diamonds
ğŸƒ	Ad
ğŸƒ‚	2d
ğŸƒƒ	3d
ğŸƒ„	4d
ğŸƒ…	5d
ğŸƒ†	6d
ğŸƒ‡	7d
ğŸƒˆ	8d
ğŸƒ‰	9d
ğŸƒŠ	Td
ğŸƒ‹	Jd
ğŸƒŒ	Nd
ğŸƒ	Qd
ğŸƒ	Kd
#
#ğŸƒ	playing card black joker
# clubs
ğŸƒ‘	Ac
ğŸƒ’	2c
ğŸƒ“	3c
ğŸƒ”	4c
ğŸƒ•	5c
ğŸƒ–	6c
ğŸƒ—	7c
ğŸƒ˜	8c
ğŸƒ™	9c
ğŸƒš	Tc
ğŸƒ›	Jc
ğŸƒœ	Nc
ğŸƒ	Qc
ğŸƒ	Kc
#
#ğŸƒŸ	playing card white joker
#
#ğŸƒ 	playing card fool
#ğŸƒ¡	playing card trump-1
#ğŸƒ¢	playing card trump-2
#ğŸƒ£	playing card trump-3
#ğŸƒ¤	playing card trump-4
#ğŸƒ¥	playing card trump-5
#ğŸƒ¦	playing card trump-6
#ğŸƒ§	playing card trump-7
#ğŸƒ¨	playing card trump-8
#ğŸƒ©	playing card trump-9
#ğŸƒª	playing card trump-10
#ğŸƒ«	playing card trump-11
#ğŸƒ¬	playing card trump-12
#ğŸƒ­	playing card trump-13
#ğŸƒ®	playing card trump-14
#ğŸƒ¯	playing card trump-15
#ğŸƒ°	playing card trump-16
#ğŸƒ±	playing card trump-17
#ğŸƒ²	playing card trump-18
#ğŸƒ³	playing card trump-19
#ğŸƒ´	playing card trump-20
#ğŸƒµ	playing card trump-21
