# https://unicode.org/charts/PDF/U10450.pdf
# https://hunterwb.com/shavian
#
# consonants
## tall
𐑐	p
𐑑	t
𐑒	k
𐑓	f
𐑔	th
𐑕	s
𐑖	sh
𐑗	ch
𐑘	y
𐑙	ng
## deep
𐑚	b
𐑛	d
𐑜	g
𐑝	v
𐑞	dh
𐑟	z
𐑠	zh
𐑡	j
𐑢	w
𐑣	h
## short
𐑤	l
𐑮	r
𐑥	m
𐑯	n
# vowels
## short
𐑦	i
𐑧	e
𐑨	a
𐑪	o
𐑫	u
𐑳	u
𐑩	'
## long
𐑰	ii
𐑱	ei
𐑭	aa
𐑲	ai
𐑬	au
𐑷	oo
𐑶	oi
𐑴	ou
𐑵	uu
## r
𐑽	ir
𐑺	er
𐑸	ar
𐑹	or
𐑻	ur
𐑼	'r
# ligatures
𐑾	𐑦𐑩
𐑿	𐑘𐑵
