# https://unicode.org/charts/PDF/U1E290.pdf
# https://unicode.org/wg2/docs/n5141-19330-toto-script.pdf
#
# Basic consonants
ğŠ	p
ğŠ‘	b
ğŠ’	t
ğŠ“	d
ğŠ”	k
ğŠ•	g
ğŠ–	m
ğŠ—	n
ğŠ˜	ng
ğŠ™	s
ğŠš	ch
ğŠ›	y
ğŠœ	w
ğŠ	j
ğŠ	h
ğŠŸ	r
ğŠ 	l
# Basic vowels
ğŠ¡	i
ğŠ¢	ih
ğŠ£	iu
ğŠ¤	iuh
ğŠ¥	u
ğŠ¦	e
ğŠ§	eh
ğŠ¨	eo
ğŠ©	eoh
ğŠª	o
ğŠ«	ae
ğŠ¬	aeh
ğŠ­	a
# Sign
ğŠ®	
