# https://unicode.org/charts/PDF/U10E80.pdf
# https://unicode.org/wg2/docs/n5053-19051r-yezidi.pdf
#
# Letters
ğº€	a
ğº	b
ğº‚	p
ğºƒ	p'
ğº„	t'
ğº…	s
ğº†	c
ğº‡	ch
ğºˆ	ch'
ğº‰	h'
ğºŠ	x
ğº‹	d
ğºŒ	z
ğº	r
ğº	r'
ğº	z
ğº	j
ğº‘	s
ğº’	sh
ğº“	s
ğº”	d
ğº•	t
ğº–	z'
ğº—	'
ğº˜	x'
ğº™	f
ğºš	v
ğº›	v
ğºœ	q
ğº	k
ğº	k'
ğºŸ	g
ğº 	l
ğº¡	m
ğº¢	n
ğº£	u
ğº¤	w
ğº¥	o
ğº¦	e
ğº§	h
ğº¨	y
ğº©	e
# Combining marks
ğº«	
ğº¬	
# Punctuation
ğº­	-
# Historical letters with diacritics
ğº°	ll
ğº±	e
